11111111111111111111111
1000P000000CCCCCCCCC1C1
1000000000000CCCCCC01C1
1000000000E0000CCCCCCC1
10000000000CCCCCCC01001
11111111111111111111111