111111111111111111111
100000C000C00CP001111
1CCC000CCC0EC00011111
111111111111111111111