1111111111111111
100000CCCCCP0011
110001C100E00111
1111111111111111