111111111111
10000000C111
1111E0P10011
111111111111